Dadaismus	Dadaismen	N;NOM;MASC;PL
Antihistaminikum	Antihistaminika	N;NOM;NEUT;PL
Prinzeß	Prinzessen	N;NOM;FEM;PL
Triregnum	Triregnen	N;NOM;NEUT;PL
Schwarzbau	Schwarzbauten	N;NOM;MASC;PL
Medizinstudium	Medizinstudien	N;NOM;NEUT;PL
Umbra	Umbren	N;NOM;FEM;PL
Filmmaterial	Filmmaterialien	N;NOM;NEUT;PL
Perigäum	Perigäen	N;NOM;NEUT;PL
Cyanobakterium	Cyanobakterien	N;NOM;NEUT;PL
Morbus	Morbi	N;NOM;MASC;PL
Possessivpronomen	Possessivpronomina	N;NOM;NEUT;PL
Pharmazeutik	Pharmazeutika	N;NOM;FEM;PL
Ikterus	Ikteri	N;NOM;MASC;PL
Enthusiasmus	Enthusiasmen	N;NOM;MASC;PL
Analogon	Analoga	N;NOM;NEUT;PL
Historismus	Historismen	N;NOM;MASC;PL
Silbermineral	Silbermineralien	N;NOM;NEUT;PL
Anaphrodisiakum	Anaphrodisiaka	N;NOM;NEUT;PL
Incubus	Incubi	N;NOM;MASC;PL
Neidbau	Neidbauten	N;NOM;MASC;PL
Aula	Aulen	N;NOM;FEM;PL
Patronymikon	Patronymika	N;NOM;NEUT;PL
Fluß	Flüsse	N;NOM;MASC;PL
Schluß	Schlüsse	N;NOM;MASC;PL
Delirium	Delirien	N;NOM;NEUT;PL
Nationalepos	Nationalepen	N;NOM;NEUT;PL
Füllmaterial	Füllmaterialien	N;NOM;NEUT;PL
Optimum	Optima	N;NOM;NEUT;PL
Obazda	Obazden	N;NOM;MASC;PL
Numerus	Numeri	N;NOM;MASC;PL
Limoncello	Limoncelli	N;NOM;MASC;PL
Rheumatismus	Rheumatismen	N;NOM;MASC;PL
Aktivismus	Aktivismen	N;NOM;MASC;PL
Datum	Daten	N;NOM;NEUT;PL
Plasma	Plasmen	N;NOM;NEUT;PL
Onomatopoetikum	Onomatopoetika	N;NOM;NEUT;PL
Edelmann	Edelleute	N;NOM;MASC;PL
Intermezzo	Intermezzi	N;NOM;NEUT;PL
Skriptorium	Skriptorien	N;NOM;NEUT;PL
Fresko	Fresken	N;NOM;NEUT;PL
Ikonoklasmus	Ikonoklasmen	N;NOM;MASC;PL
Todesdatum	Todesdaten	N;NOM;NEUT;PL
Theismus	Theismen	N;NOM;MASC;PL
Observatorium	Observatorien	N;NOM;NEUT;PL
Ösophagospasmus	Ösophagospasmen	N;NOM;MASC;PL
Monstrum	Monstren, Monstra	N;NOM;NEUT;PL
Lebenszyklus	Lebenszyklen	N;NOM;MASC;PL
Oktopus	Oktopoden	N;NOM;MASC;PL
Volumen	Volumina	N;NOM;NEUT;PL
Energieministerium	Energieministerien	N;NOM;NEUT;PL
Coronavirus	Coronaviren	N;NOM;NEUT;PL
Fatwa	Fatwen	N;NOM;FEM+NEUT;PL
Martyrologium	Martyrologien	N;NOM;NEUT;PL
Aneurysma	Aneurysmen	N;NOM;NEUT;PL
Fatum	Fata	N;NOM;NEUT;PL
Chiasmus	Chiasmen	N;NOM;MASC;PL
Veranda	Veranden	N;NOM;FEM;PL
Haruspex	Haruspizes	N;NOM;MASC;PL
Kommando	Kommanden	N;NOM;NEUT;PL
Kommando	Kommanda	N;NOM;NEUT;PL
Rektionskompositum	Rektionskomposita	N;NOM;NEUT;PL
Rektionskompositum	Rektionskompositen	N;NOM;NEUT;PL
Reaktorbau	Reaktorbauten	N;NOM;MASC;PL
Versal	Versalien	N;NOM;MASC;PL
Paroxysmus	Paroxysmen	N;NOM;MASC;PL
Herbarium	Herbarien	N;NOM;NEUT;PL
Tempus	Tempora	N;NOM;NEUT;PL
Heros	Heroen	N;NOM;MASC;PL
Anlaß	Anlässe	N;NOM;MASC;PL
Romni	Romnija	N;NOM;FEM;PL
Organismus	Organismen	N;NOM;MASC;PL
Suicidium	Suicidien	N;NOM;NEUT;PL
Gründungsprivileg	Gründungsprivilegien	N;NOM;NEUT;PL
Refugium	Refugien	N;NOM;NEUT;PL
Pater	Patres	N;NOM;MASC;PL
Nomen	Nomina	N;NOM;NEUT;PL
Forum	Foren	N;NOM;NEUT;PL
Autosemantikum	Autosemantika	N;NOM;NEUT;PL
Vagina	Vaginen	N;NOM;FEM;PL
Kippah	Kippot	N;NOM;FEM;PL
Lady	Ladies	N;NOM;FEM;PL
Beige	Beige(s)	N;NOM;NEUT;PL
Kriterium	Kriterien	N;NOM;NEUT;PL
Quadriga	Quadrigen	N;NOM;FEM;PL
Metabolismus	Metabolismen	N;NOM;MASC;PL
Misstrauensvotum	Misstrauensvota	N;NOM;NEUT;PL
Misstrauensvotum	Misstrauensvoten	N;NOM;NEUT;PL
Minimum	Minima	N;NOM;NEUT;PL
Blackbox	Blackboxes	N;NOM;FEM;PL
Gerundium	Gerundien	N;NOM;NEUT;PL
Balzarena	Balzarenen	N;NOM;FEM;PL
Nanomaterial	Nanomaterialien	N;NOM;NEUT;PL
Maskulinum	Maskulina	N;NOM;NEUT;PL
Endometrium	Endometrien	N;NOM;NEUT;PL
Fürstprimas	Fürstprimaten	N;NOM;MASC;PL
Dichtungsmaterial	Dichtungsmaterialien	N;NOM;NEUT;PL
Spezies	Spezien	N;NOM;FEM;PL
Skrotum	Skrota	N;NOM;NEUT;PL
Wehrmann	Wehrleute	N;NOM;MASC;PL
Prostylos	Prostyloi	N;NOM;MASC;PL
Sprachpurismus	Sprachpurismen	N;NOM;MASC;PL
Delta	Delten	N;NOM;NEUT;PL
Aphrodisiakum	Aphrodisiaka	N;NOM;NEUT;PL
Benutzerkonto	Benutzerkonten	N;NOM;NEUT;PL
Metonym	Metonyma	N;NOM;NEUT;PL
Stadium	Stadien	N;NOM;NEUT;PL
Altneubau	Altneubauten	N;NOM;MASC;PL
Innenministerium	Innenministerien	N;NOM;NEUT;PL
Nährmedium	Nährmedien	N;NOM;NEUT;PL
Abaton	Abata	N;NOM;NEUT;PL
Gremium	Gremien	N;NOM;NEUT;PL
Fetus	Feten	N;NOM;MASC;PL
Prisma	Prismen	N;NOM;NEUT;PL
Hepatitis	Hepatitiden	N;NOM;FEM;PL
Bügelverschluß	Bügelverschlüsse	N;NOM;MASC;PL
Generikum	Generika	N;NOM;NEUT;PL
Ausschlusskriterium	Ausschlusskriterien	N;NOM;NEUT;PL
Handy	Handies	N;NOM;NEUT;PL
Fährmann	Fährleute	N;NOM;MASC;PL
Aphorismus	Aphorismen	N;NOM;MASC;PL
Sozialismus	Sozialismen	N;NOM;MASC;PL
Periastron	Periastra	N;NOM;NEUT;PL
Agenda	Agenden	N;NOM;FEM;PL
Podium	Podien	N;NOM;NEUT;PL
Agrammatismus	Agrammatismen	N;NOM;MASC;PL
Antiphlogistikum	Antiphlogistika	N;NOM;NEUT;PL
Antioxidans	Antioxidantien	N;NOM;NEUT;PL
Umweltministerium	Umweltministerien	N;NOM;NEUT;PL
Finanzministerium	Finanzministerien	N;NOM;NEUT;PL
Krematorium	Krematorien	N;NOM;NEUT;PL
Okarina	Okarinen	N;NOM;FEM;PL
Ziborium	Ziborien	N;NOM;NEUT;PL
Basilikum	Basiliken	N;NOM;NEUT;PL
Papyrus	Papyri	N;NOM;MASC;PL
Chanukkia	Chanukkiot	N;NOM;FEM;PL
Ausgangsmaterial	Ausgangsmaterialien	N;NOM;NEUT;PL
Monopodium	Monopodien	N;NOM;NEUT;PL
Einkaufszentrum	Einkaufszentren	N;NOM;NEUT;PL
Pulcinella	Pulcinelle	N;NOM;MASC;PL
Kodex	Kodizes	N;NOM;MASC;PL
Penumbra	Penumbren	N;NOM;FEM;PL
Postludium	Postludien	N;NOM;NEUT;PL
Überschuß	Überschüsse	N;NOM;MASC;PL
Atrium	Atrien	N;NOM;NEUT;PL
Stracciatella	Stracciatelle	N;NOM;NEUT;PL
Orgasmus	Orgasmen	N;NOM;MASC;PL
Zaddik	Zaddikim	N;NOM;MASC;PL
Suchalgorithmus	Suchalgorithmen	N;NOM;MASC;PL
Blasslila	Blasslila(s)	N;NOM;NEUT;PL
Helvetismus	Helvetismen	N;NOM;MASC;PL
Lyzeum	Lyzeen	N;NOM;NEUT;PL
Sexta	Sexten	N;NOM;FEM;PL
Ionenradius	Ionenradien	N;NOM;MASC;PL
Hapaxlegomenon	Hapaxlegomena	N;NOM;NEUT;PL
Uterus	Uteri	N;NOM;MASC;PL
Schloß	Schlösser	N;NOM;NEUT;PL
Mora	Moren	N;NOM;FEM;PL
Apsis	Apsiden	N;NOM;FEM;PL
Kosmos	Kosmen	N;NOM;MASC;PL
Imperium	Imperien	N;NOM;NEUT;PL
Verteidigungsministerium	Verteidigungsministerien	N;NOM;NEUT;PL
Zinnmineral	Zinnmineralien	N;NOM;NEUT;PL
Kondominium	Kondominien	N;NOM;NEUT;PL
Präsens	Präsentia	N;NOM;NEUT;PL
Präsens	Präsentien	N;NOM;NEUT;PL
Präsens	Präsenzien	N;NOM;NEUT;PL
Geburtsdatum	Geburtsdaten	N;NOM;NEUT;PL
Vorbau	Vorbauten	N;NOM;MASC;PL
Prinzip	Prinzipien	N;NOM;NEUT;PL
Atlas	Atlanten	N;NOM;MASC;PL
Antidepressivum	Antidepressiva	N;NOM;NEUT;PL
Anachronismus	Anachronismen	N;NOM;MASC;PL
Hellgelb	Hellgelb(s)	N;NOM;NEUT;PL
Inkubus	Inkuben	N;NOM;MASC;PL
Katalysemechanismus	Katalysemechanismen	N;NOM;MASC;PL
Caldera	Calderen	N;NOM;FEM;PL
Klitikon	Klitika	N;NOM;NEUT;PL
Bütterken	Bütterkes	N;NOM;NEUT;PL
Außenministerium	Außenministerien	N;NOM;NEUT;PL
Referendum	Referenden	N;NOM;NEUT;PL
Kultusministerium	Kultusministerien	N;NOM;NEUT;PL
Tombola	Tombolen	N;NOM;FEM;PL
Abtreibungsbefürworter	AbtreibungsbefürworterAbortion	N;NOM;MASC;PL
Material	Materialien	N;NOM;NEUT;PL
Globus	Globen	N;NOM;MASC;PL
Breitbandantibiotikum	Breitbandantibiotika	N;NOM;NEUT;PL
Bakterium	Bakterien	N;NOM;NEUT;PL
Publikum	Publika	N;NOM;NEUT;PL
Terminus	Termini	N;NOM;MASC;PL
Eutektikum	Eutektika	N;NOM;NEUT;PL
Apex	Apizes	N;NOM;MASC;PL
Gingivitis	Gingivitiden	N;NOM;FEM;PL
Apogäum	Apogäen	N;NOM;NEUT;PL
Razzia	Razzien	N;NOM;FEM;PL
Policinello	Policinelli	N;NOM;MASC;PL
Primarius	Primarien	N;NOM;MASC;PL
Quinta	Quinten	N;NOM;FEM;PL
Herzrhythmus	Herzrhythmen	N;NOM;MASC;PL
Tonmineral	Tonmineralien	N;NOM;NEUT;PL
Dialektkontinuum	Dialektkontinua	N;NOM;NEUT;PL
Auditorium	Auditorien	N;NOM;NEUT;PL
Genderismus	Genderismen	N;NOM;MASC;PL
Tertia	Tertien	N;NOM;FEM;PL
Kopulativkompositum	Kopulativkomposita	N;NOM;NEUT;PL
Kopulativkompositum	Kopulativkompositen	N;NOM;NEUT;PL
Realgymnasium	Realgymnasien	N;NOM;NEUT;PL
Fotoalbum	Fotoalben	N;NOM;NEUT;PL
Feminismus	Feminismen	N;NOM;MASC;PL
Marasmus	Marasmen	N;NOM;MASC;PL
Zentrum	Zentren	N;NOM;NEUT;PL
Röntgenspektrum	Röntgenspektren	N;NOM;NEUT;PL
Exerzitium	Exerzitien	N;NOM;NEUT;PL
Datscha	Datschen	N;NOM;FEM;PL
Graffito	Graffiti	N;NOM;MASC+NEUT;PL
Graffito	Graffiti	N;NOM;MASC+NEUT;PL
Gecko	Geckonen	N;NOM;MASC;PL
Freizeitzentrum	Freizeitzentren	N;NOM;NEUT;PL
Utrum	Utra	N;NOM;NEUT;PL
Dunkelblau	Dunkelblau(s)	N;NOM;NEUT;PL
Stimulus	Stimuli	N;NOM;MASC;PL
Altersaufbau	Altersaufbauten	N;NOM;MASC;PL
Regierungspräsidium	Regierungspräsidien	N;NOM;NEUT;PL
Millennium	Millennien	N;NOM;NEUT;PL
Praeteritio	Praeteritionen	N;NOM;FEM;PL
Emporium	Emporien	N;NOM;NEUT;PL
Wasserscheu	Wasserscheun-sg	N;NOM;FEM;PL
Abecedarium	Abecedarien	N;NOM;NEUT;PL
Mutismus	Mutismen	N;NOM;MASC;PL
Lexikon	Lexika	N;NOM;NEUT;PL
Evangelium	Evangelien	N;NOM;NEUT;PL
Evangelium	Evangelia	N;NOM;NEUT;PL
Dreikäsehoch	Dreikäsehoch(s)	N;NOM;MASC;PL
Politikum	Politika	N;NOM;NEUT;PL
Primas	Primaten	N;NOM;MASC;PL
Algorithmus	Algorithmen	N;NOM;MASC;PL
Neophyt	Neophyta	N;NOM;MASC;PL
Verfallsdatum	Daten	N;NOM;NEUT;PL
a-Schwa	a-Schwa(s)	N;NOM;NEUT;PL
Aschkenasi	Aschkenasim	N;NOM;MASC;PL
Cytostatikum	Cytostatika	N;NOM;NEUT;PL
Metropolis	Metropolen	N;NOM;FEM;PL
Provisorium	Provisorien	N;NOM;NEUT;PL
Pockenvirus	Pockenviren	N;NOM;MASC+NEUT;PL
Paradoxon	Paradoxa	N;NOM;NEUT;PL
Pluraletantum	Pluraletanta	N;NOM;PL
Pluraletantum	Pluraliatanta	N;NOM;PL
Album	Alben	N;NOM;NEUT;PL
Tutorium	Tutorien	N;NOM;NEUT;PL
Hibiskus	Hibisken	N;NOM;MASC;PL
Konsortium	Konsortien	N;NOM;NEUT;PL
Liquida	Liquidä	N;NOM;FEM;PL
Liquida	Liquiden	N;NOM;FEM;PL
Isomorphismus	Isomorphismen	N;NOM;MASC;PL
Scheinanglizismus	Scheinanglizismen	N;NOM;MASC;PL
Aura	Auren	N;NOM;FEM;PL
Alpha privativum	Alpha privativa	N;NOM;NEUT;PL
Numerale	Numeralia	N;NOM;NEUT;PL
Textil	Textilien	N;NOM;NEUT;PL
Katechismus	Katechismen	N;NOM;MASC;PL
Diskussionsforum	Diskussionsforen	N;NOM;NEUT;PL
Laboratorium	Laboratorien	N;NOM;NEUT;PL
Numerale	Numeralia	N;NOM;NEUT;PL
Textil	Textilien	N;NOM;NEUT;PL
Katechismus	Katechismen	N;NOM;MASC;PL
Diskussionsforum	Diskussionsforen	N;NOM;NEUT;PL
Laboratorium	Laboratorien	N;NOM;NEUT;PL
Iota subscriptum	Iota subscripta	N;NOM;NEUT;PL
Artepithet	Artepitheta	N;NOM;NEUT;PL
Bindungsabstand	Bindungsabstandes	N;NOM;MASC;PL
Plattenbau	Plattenbauten	N;NOM;MASC;PL
Normdatum	Normdaten	N;NOM;NEUT;PL
Bankkonto	Bankkonten	N;NOM;NEUT;PL
Hauptthema	Hauptthemen	N;NOM;NEUT;PL
Bakkalaureus	Bakkalaurei	N;NOM;MASC;PL
Baumaterial	Baumaterialien	N;NOM;NEUT;PL
Amphiprostylos	Amphiprostylen	N;NOM;MASC;PL
Reflexivum	Reflexiva	N;NOM;NEUT;PL
Dielektrikum	Dielektrika	N;NOM;NEUT;PL
Thalamus	Thalami	N;NOM;MASC;PL
Puerperium	Puerperien	N;NOM;NEUT;PL
Imperialismus	Imperialismen	N;NOM;MASC;PL
Bestiarium	Bestiarien	N;NOM;NEUT;PL
Geschäftsmann	Geschäftsleute	N;NOM;MASC;PL
Inkreisradius	Inkreisradien	N;NOM;MASC;PL
Gymnasium	Gymnasien	N;NOM;NEUT;PL
Paralleluniversum	Paralleluniversen	N;NOM;NEUT;PL
Praktikum	Praktika	N;NOM;NEUT;PL
Grippevirus	Grippeviren	N;NOM;MASC+NEUT;PL
Museum	Museen	N;NOM;NEUT;PL
Index	Indizes	N;NOM;MASC;PL
Plazenta	Plazenten	N;NOM;FEM;PL
Sanatorium	Sanatorien	N;NOM;NEUT;PL
Spülsaummaterial	Spülsaummaterialien	N;NOM;NEUT;PL
Barockschloß	Barockschlösser	N;NOM;NEUT;PL
Aquarium	Aquarien	N;NOM;NEUT;PL
Gerundivum	Gerundiva	N;NOM;NEUT;PL
Abschluß	Abschlüsse	N;NOM;MASC;PL
Kurkuma	Kurkumen	N;NOM;FEM;PL
Abbruchfirma	Abbruchfirmen	N;NOM;FEM;PL
Seemann	Seeleute	N;NOM;MASC;PL
Mechanismus	Mechanismen	N;NOM;MASC;PL
Mythos	Mythen	N;NOM;MASC;PL
Kompositum	Komposita	N;NOM;NEUT;PL
Kompositum	Kompositen	N;NOM;NEUT;PL
Thema	Themen	N;NOM;NEUT;PL
Sauna	Saunen	N;NOM;FEM;PL
Patronymikum	Patronymika	N;NOM;NEUT;PL
Hypothalamus	Hypothalami	N;NOM;MASC;PL
Freilichtmuseum	Freilichtmuseen	N;NOM;NEUT;PL
Chromatizität	Chromatizitätundefined	N;NOM;PL
Kippa	Kippot	N;NOM;FEM;PL
Analgetikum	Analgetika	N;NOM;NEUT;PL
Okkasionalismus	Okkasionalismen	N;NOM;MASC;PL
Vakuum	Vakua	N;NOM;NEUT;PL
Vakuum	Vakuen	N;NOM;NEUT;PL
Sophismus	Sophismen	N;NOM;MASC;PL
Individuum	Individuen	N;NOM;NEUT;PL
Votum	Vota	N;NOM;NEUT;PL
Votum	Voten	N;NOM;NEUT;PL
Anästhetikum	Anästhetika	N;NOM;NEUT;PL
Sympodium	Sympodien	N;NOM;NEUT;PL
Codex	Codices	N;NOM;MASC;PL
Magma	Magmen	N;NOM;NEUT;PL
Zirconiummineral	Zirconiummineralien	N;NOM;NEUT;PL
Hauptmann	Hauptleute	N;NOM;MASC;PL
Ministerium	Ministerien	N;NOM;NEUT;PL
Epitheton	Epitheta	N;NOM;NEUT;PL
Bau	Bauten	N;NOM;MASC;PL
Äquinoktium	Äquinoktien	N;NOM;NEUT;PL
Ameisenalgorithmus	Ameisenalgorithmen	N;NOM;MASC;PL
Nanobakterium	Nanobakterien	N;NOM;NEUT;PL
Oxytonon	Oxytona	N;NOM;NEUT;PL
Nierentubulus	Nierentubuli	N;NOM;MASC;PL
Perikambium	Perikambien	N;NOM;NEUT;PL
Stadtzentrum	Stadtzentren	N;NOM;NEUT;PL
Multiversum	Multiversen	N;NOM;NEUT;PL
Euphemismus	Euphemismen	N;NOM;MASC;PL
Übergangsritus	Übergangsriten	N;NOM;MASC;PL
Konservatorium	Konservatorien	N;NOM;NEUT;PL
Landsmann	Landsleute	N;NOM;MASC;PL
Heterocyclus	Heterocyclen	N;NOM;NEUT;PL
Harmonium	Harmonien	N;NOM;NEUT;PL
Paparazza	Paparazze	N;NOM;FEM;PL
Epos	Epen	N;NOM;NEUT;PL
Tempo	Tempi	N;NOM;NEUT;PL
Ektoplasma	Ektoplasmen	N;NOM;NEUT;PL
Asterismus	Asterismen	N;NOM;MASC;PL
Verschlüsselungsalgorithmus	Verschlüsselungsalgorithmen	N;NOM;MASC;PL
Cherub	Cherubim	N;NOM;MASC;PL
Cherub	Cherubinen	N;NOM;MASC;PL
Visum	Visen	N;NOM;NEUT;PL
Visum	Visa	N;NOM;NEUT;PL
Myzel	Myzelien	N;NOM;NEUT;PL
Purismus	Purismen	N;NOM;MASC;PL
Eukalyptus	Eukalypten	N;NOM;MASC;PL
Pharmakon	Pharmaka	N;NOM;NEUT;PL
Rassismus	Rassismen	N;NOM;MASC;PL
Antibiotikum	Antibiotika	N;NOM;NEUT;PL
Bundesministerium	Bundesministerien	N;NOM;NEUT;PL
Fellatio	Fellationes	N;NOM;FEM;PL
Anabolikum	Anabolika	N;NOM;NEUT;PL
Partizip	Partizipien	N;NOM;NEUT;PL
Terrarium	Terrarien	N;NOM;NEUT;PL
Tabuthema	Tabuthemen	N;NOM;MASC;PL
Ovarium	Ovarien	N;NOM;NEUT;PL
Kernthema	Kernthemen	N;NOM;NEUT;PL
Elysium	Elysien	N;NOM;NEUT;PL
Arbeitsministerium	Arbeitsministerien	N;NOM;NEUT;PL
Bocher	Bocherim	N;NOM;MASC;PL
Jubiläum	Jubiläen	N;NOM;NEUT;PL
Präsidium	Präsidien	N;NOM;NEUT;PL
Extremum	Extrema	N;NOM;NEUT;PL
Prima	Primen	N;NOM;MASC;PL
Salto	Saltos/Salti	N;NOM;MASC;PL
Apastron	Apastra	N;NOM;NEUT;PL
Bazillus	Bazillen	N;NOM;MASC;PL
Brennschluß	Brennschlüsse	N;NOM;MASC;PL
Gesundheitsministerium	Gesundheitsministerien	N;NOM;NEUT;PL
Zyklus	Zyklen	N;NOM;MASC;PL
Modus	Modi	N;NOM;MASC;PL
Fischereiministerium	Fischereiministerien	N;NOM;NEUT;PL
Neuroleptikum	Neuroleptika	N;NOM;NEUT;PL
Abstraktum	Abstrakta	N;NOM;NEUT;PL
Ranch	Ranches	N;NOM;FEM;PL
Determinativkompositum	Determinativkomposita	N;NOM;NEUT;PL
Determinativkompositum	Determinativkompositen	N;NOM;NEUT;PL
Paparazzo	Paparazzi	N;NOM;MASC;PL
Arbeitspensum	Arbeitspensen	N;NOM;NEUT;PL
Hellblau	Hellblau(s)	N;NOM;NEUT;PL
Tundra	Tundren	N;NOM;FEM;PL
Diaphragma	Diaphragmen	N;NOM;NEUT;PL
Mindesthaltbarkeitsdatum	Mindesthaltbarkeitsdaten	N;NOM;NEUT;PL
Wirtschaftsministerium	Wirtschaftsministerien	N;NOM;NEUT;PL
Anwendungsspektrum	Anwendungsspektren	N;NOM;NEUT;PL
Swastika	Swastiken	N;NOM;FEM;PL
Kollektivum	Kollektiva	N;NOM;NEUT;PL
Fernstudium	Fernstudien	N;NOM;NEUT;PL
Korona	Koronen	N;NOM;FEM;PL
Hausbau	Hausbauten	N;NOM;MASC;PL
Viola	Violen	N;NOM;FEM;PL
Dunkelgelb	Dunkelgelb(s)	N;NOM;NEUT;PL
Beschichtungsmaterial	Beschichtungsmaterialien	N;NOM;NEUT;PL
Anlagenbau	Anlagenbauten	N;NOM;MASC;PL
Mineral	Mineralien	N;NOM;NEUT;PL
Universum	Universen	N;NOM;NEUT;PL
Teutonismus	Teutonismen	N;NOM;MASC;PL
Immunsuppressivum	Immunsuppressiva	N;NOM;NEUT;PL
Nebenthema	Nebenthemen	N;NOM;NEUT;PL
Quorum	Quoren	N;NOM;NEUT;PL
Pizza	Pizzen	N;NOM;FEM;PL
Solarium	Solarien	N;NOM;NEUT;PL
Possessivkompositum	Possessivkomposita	N;NOM;NEUT;PL
Possessivkompositum	Possessivkompositen	N;NOM;NEUT;PL
Gefolgsmann	Gefolgsleute	N;NOM;MASC;PL
Altmaterial	Altmaterialien	N;NOM;NEUT;PL
Charakteristikum	Charakteristika	N;NOM;NEUT;PL
Frater	Fratres	N;NOM;MASC;PL
Gastritis	Gastritiden	N;NOM;FEM;PL
Atavismus	Atavismen	N;NOM;MASC;PL
Antaphrodisiakum	Antaphrodisiaka	N;NOM;NEUT;PL
Typus	Typen	N;NOM;MASC;PL
Indiz	Indizien	N;NOM;NEUT;PL
Justizministerium	Justizministerien	N;NOM;NEUT;PL
Rom	Roma	N;NOM;MASC;PL
Altbau	Altbauten	N;NOM;MASC;PL
Tremor	Tremores	N;NOM;MASC;PL
Myzelium	Myzelien	N;NOM;NEUT;PL
Fiskus	Fisken	N;NOM;MASC;PL
Melodrama	Melodramen	N;NOM;NEUT;PL
Bindungstypus	Bindungstypen	N;NOM;MASC;PL
Studium	Studien	N;NOM;NEUT;PL
Krampus	Krampi	N;NOM;MASC;PL
Phraseologismus	Phraseologismen	N;NOM;MASC;PL
Quarta	Quarten	N;NOM;FEM;PL
Goropismus	Goropismen	N;NOM;MASC;PL
Kleinod	Kleinodien	N;NOM;NEUT;PL
Nachweisreagenz	Nachweisreagenzien	N;NOM;NEUT;PL
Abdomen	Abdomina	N;NOM;NEUT;PL
Aufbau	Aufbauten	N;NOM;MASC;PL
Blutplasma	Blutplasmen	N;NOM;NEUT;PL
Ritus	Riten	N;NOM;MASC;PL
Eigenkapital	Eigenkapitalien	N;NOM;NEUT;PL
Risiko	Risiken	N;NOM;NEUT;PL
Kriegsministerium	Kriegsministerien	N;NOM;NEUT;PL
Impressum	Impressen	N;NOM;NEUT;PL
Apiarium	Apiarien	N;NOM;NEUT;PL
Narkotikum	Narkotika	N;NOM;NEUT;PL
Kuriosum	Kuriosa	N;NOM;NEUT;PL
Feuerwehrmann	Feuerwehrleute	N;NOM;MASC;PL
Tellurium	Tellurien	N;NOM;NEUT;PL
Psychopharmakon	Psychopharmaka	N;NOM;NEUT;PL
Wirkmechanismus	Wirkmechanismen	N;NOM;MASC;PL
Astigmatismus	Astigmatismen	N;NOM;MASC;PL
Briefkastenfirma	Briefkastenfirmen	N;NOM;FEM;PL
Penny	Pence	N;NOM;MASC;PL
Königsschloß	Königsschlösser	N;NOM;NEUT;PL
Faktum	Fakten	N;NOM;NEUT;PL
Faktum	Fakta	N;NOM;NEUT;PL
Maximum	Maxima	N;NOM;NEUT;PL
Soja	Sojen	N;NOM;FEM+NEUT;PL
Soja	Sojen	N;NOM;FEM+NEUT;PL
Gesprächsthema	Gesprächsthemen	N;NOM;NEUT;PL
Planetarium	Planetarien	N;NOM;NEUT;PL
Adverb	Adverbien	N;NOM;NEUT;PL
Kassa	Kassen	N;NOM;FEM;PL
Bildungsministerium	Bildungsministerien	N;NOM;NEUT;PL
Abwehrmechanismus	Abwehrmechanismen	N;NOM;MASC;PL
Lyra	Lyren	N;NOM;FEM;PL
Aroma	Aromen	N;NOM;NEUT;PL
Moratorium	Moratorien	N;NOM;NEUT;PL
Forschungszentrum	Forschungszentren	N;NOM;NEUT;PL
Präantepänultima	Präantepänultimä	N;NOM;FEM;PL
Omen	Omina	N;NOM;NEUT;PL
Territorium	Territorien	N;NOM;NEUT;PL
Nierenglomerulus	Nierenglomeruli	N;NOM;MASC;PL
Kaufmann	Kaufleute	N;NOM;MASC;PL
Drama	Dramen	N;NOM;NEUT;PL
Arena	Arenen	N;NOM;FEM;PL
Jarmulke	Jarmulka	N;NOM;FEM;PL
Girokonto	Girokonten	N;NOM;NEUT;PL
